5 6
8 7 6 5 4 1
8 8 7 6 5 7
9 8 7 6 5 1
8 8 7 6 5 7
8 7 6 5 4 1